0 39   167 49 50 51 52 53 54 55 56 57 48 43 0
1 41   9 229 228 246 112 121 102 103 99 114 108 44 314 0
2 46    97 111 101 117 105 100 104 116 110 115 45 39 0
3 42    304 60 46 113 106 107 120 98 109 119 118 122 0
4 20   282 283 284 285 286 287 288 289 290 291 292 293
-1